#level 1
*********************************************
*                                           *
*                                           *
*         *                                 *
*                                           *
*                               *           *
*                                           *
*                                           *
*                                           *
*                                           *
*                                           *
*                                           *
*                *                          *
*                                           *
*                                           *
*                                           *
*                 *                         *
*                                           *
*                                           *
*                                           *
*********************************************
